*#*#*##*#*#*##*#*#*##
#                   *
*  *                #
*  *  $     S       i
*  *                #
*                *  #
*#*#*##*#*#*##*#*#*##